WWWWWDWMWMMWW
AQMMAMWMWWWWW
AMMMAMMMMMBBB
AMMMAAMDMBDBB
ACWMMADMMBDCM
ACPMDAAMWBBMM
ACMMWDBBBBBAA
AWWDWWBCCCBAA
DAWBBBBDBBBMA
AADBBBBWWWWMM
AMBBWWMWEMMMW
AMBBWTPUWMMMW
AMBBWQVOWWWWW

MEMEMEMEMEMEMEHHHHHH

