WWWWWWWWWWWWW
DMWMMWWWWMMMD
OQMOQBBBBOWWQ
MOMQMBBBBONNM
MMWMMBDDBMPPQ
QMWMWCCCCOWWQ
MMMMWDMDDMMDM
WWWWDWMWDWWWW
WWMMMMMMMMMOW
MBNNNDDNNNNDM
DBBBBBBBBBBBM
WWBBBTPUBBBBW
WWGOWQVOWWOWW

HEEMMHHMMHMMMMMHHEHH