WAAAAAWAAAAAW
MMWMMMWAAAAAW
WMWMWMWAAAAAW
MMWMWMWAAAAAW
WMWMWMWAAAAAW
MMWMMMWAAAAAA
AAAAAAAAAADWW
WPDPWWWWDMBPW
WMMMWPWPBMBMD
DMMMDMDMBWBMW
WNWNWMWMBMBMW
WWWWWTPUBMBBB
WWWWWQVPWWWWW

EMEMEMHEHEMEMHEEEMHE