WWWDWWWWWWBMW
WWWMWMWMWWBMW
BBMMWMDMWWBWW
WWMMWDWWABBWW
WMDWWMBMDMBBW
MMWWDMBWWWMMM
MBBDMMBMWWWWW
BMWMWMWMWMDMC
WMWMWCCMCCCMW
WMMMWMDMCBBMW
WMMMWWWWCBCMW
WWWWWTPUCBCMW
WWWWWQVOWWAAA

HMEMHHHEEEMHEEEEEHME