WWWWWWWMMMWWW
BMMMPWPWWMWWW
BWWWMWNWWWWMM
BCCCCCWMOCCME
BBGGGCWMWDFMB
MBMMMCCCWCMMB
BBBBDCBBDCBBB
CCCWCCMMWCWWB
MWWWWMEEWCCDB
AMMWWWWWWWWWB
AMMWEEWWDMMWA
DMMWWTPUWMAAA
MMMWWQVOWMMMM

HEHEHEHEHEHEHEHEHEHE