WQWOBBWAWWAOW
OWWWQBOQBWAOH
OWMWQBOQBWAMW
MMDMMBWMBBAWW
ENMONFWBBMMMO
WBMBWWOMMBCAA
QBBBOAAACBDMM
NBBBNOMMDBEEE
PWBWPWEEEBAMA
MWWWDAAAAMBMO
WNWNWWOMBWWWN
WWWWWTPUBWWWD
WWWWWQVOBWWWW

EEEEEEEMMMMMMMMMMMMH