WMMWWWWWWWWWW
MWWWMMDWWWDWM
WWMWAWWABBBBB
MBMMACCACCBBW
NWAAACAAWWWWM
CCACCCAMMMMMW
CMMMOAAWAWWWW
CWWWWAHFAACCC
CMDMDMHWAWWWW
PWWWWWHMMWDWW
MNNNMPWWWWMMN
DWWWWTPUWWNWD
WWWWWQVOWWWAA

HMEMHMHMHHMMEMHMHHHE