WAAAMAWAAWABW
MWWWWWGGGMDBB
AAAAAAAAAMCBB
WWWMWMMMMMCBB
MMMNWMWQWWCBB
WWMWWWWQWWCBA
AADDDAABAACPW
WWWWWBBBBDDMM
OPNNNBBBBWMWW
WMWPPBBBBMMWW
WWWNNCBBCMMMW
WWWWWTPUCWDMM
WWWWWQVOWWWAB

EHMHEMHMEHMHEEEHMHHE