WWWWWWWBBBBAW
WMMBBBBWBBBAW
MBBAMMWWEEEWA
MAAMMBBOWWWWQ
WWWNMMWOWCCWQ
FWFWMOWWWWWWM
PPWWMOWCCMDWM
BBAMMMWBMMDQM
BMMMMMOBMMANN
BMMMMNNBMMAMM
NMMNPMMABBBWN
WWWWNTPUBMDBW
WWWWWQVOWWWMW

EMHHEHHMEHMHMEEMHHEM