WWWEEWWWWWWWW
EEWWWWDWWWMWC
WWBWEMCWMWWMW
WBDWWWCMWWWWM
BCDBBBCDWWDDB
CDDWDMBWWBBBB
CMWWMDWBBBFWW
DWMDDWWHBWWHD
WWMMBWWDBWWDW
WMDBMWDDBWWEE
MWBWWDWWBMMCC
PPWWWTPUDMMMM
MMWWWQVOWWWWM

MMMEMEMEMEMEMEMMEMME