WWWDWWWDWWWWW
BMWDWWWMWMWMW
BMWBBBMMWMDMW
BWWMWWMMWDWWA
BWWMWMDWWMBMD
BBWMMMWWDMBWW
MMMMMBBDMMBMW
WWWDBMWMWMWMW
DMCDWMWMWCCMC
CMWMWMMMWMDMC
BMWMWMMMWWWWC
CMWWWTPUWMWMC
CMWMWQVOWMMMW

EEEEEEEEMMMMMMMMMMHH