WWWWBGWWWWMMW
WBGBBDFMMBBCB
BHDFBEBCMMMCH
FBEBWWWCBBMCB
BWWWWWWCMMMCW
GBWBGBWCMBDMW
DFWHDFWMMMMCW
EBWBEBWCBBMCW
GBWBGBWCMMMCW
DFWHDFWCMBBCW
EBWBEBWCMMMMP
WWWWWTPUMMMMM
WWDWWQVOMWWWW

MMMMMEEEEEMMMMMEEEEE