WMWPWMWWWWBMW
WMWGWMMWWWBBB
WNWMWNWQOWBCC
CCMCCCCBBBMMW
WWMPWWBBBBMBM
WQDMDMMEEMMMW
MMMMBMMMMBBBW
BGBBBBBDWMDCW
CCCCWCCCCMBBW
WWPPWWWWAMBBM
OWWQWGPMAMBGM
OWWWWTPUAMAAM
WWWWWQVOAWWWW

EEEEEEEEEEEEEEEEEEEE