WWWWWWWWWMDMW
MWWWWMMMDMOQM
QBBBBOWWQMMOM
MBBBBONNMMMMW
MBDDBMPPQOQMW
WBBBBMMDMWWWW
WDMDDMMDMWWWW
DWMWDWWWWWWWM
MMMMMMMOWWMBN
NDDNNNNDMGDBB
BBBBBBBBMMWWB
BPPPBTPUWWWWG
WMWMWQVOWWWWW

EMHMHHHHMHHMHEHHHMEE