WAAAAWWBBBMWW
WWGGGMDBBBAAA
AAAAAMCBBBWWW
WMMMMMCBBBMMM
WMWQWWCBBBWWM
WWWWWWCBAAAAD
DAABAACPWPWWW
WBBBBDDMMMOQN
NBBBBWMWWWWMW
PBBBBMMWWFWWW
NCBBCMMMWFWWW
WBBBCTPUMMWWW
WMMWWQVOBWWWW

EMHEMMMEEMHEEEEEEMHE