WAAAAAWAWMMMW
MMWAAAAAWMWMW
WMWAAAAAWMMMW
WMWAAAAAWWWMW
WMWAAAAAWMMMW
MMWAAAAAAAAAA
AAAAAADWWWWPD
WWWWDMBPWPWMM
WPWPBMBMDMDMM
DMDMBWBMWMWNW
WMWMBMBMWMWWW
WMWMBTPUBWWWW
WWBBWQVOWDWWW

EMHEMHEMMEMMMEEEEHHH