WWWBBBWAWWPMW
BBBWBBBAWQMBB
MMPWEEEWAMMAA
MBBOWWWWQNWWW
MMWOWCCWQWFWF
MOWWWWWWMWPPW
MOWCCMDWMMBBA
MMWBMMDQMMBMM
MMOBMMANNMBMM
MNNBMMAMMPNMM
PMMABBBWNNWWW
NNWBBTPUWWWWW
WWBBWQVOWWMMM

HMEMHMEEEEMHHEHHMEEE