WDWMWMWWWWAQW
AMWMWWWWWWAMM
AMMMMMBBBBAMM
AAMDMBDBBBACW
MADMMBDCMMACN
DAAMWBBMMMACM
WDBBBBBAAWAWW
WWBCCCBAAMDAW
BBBDBBBMAMAAD
BBBWWWWMMMAMB
WWMWNMMMWWAMB
WWMWWTPUWWAMB
WWMWWQVOWWBWW

HMEMHHHHHMEEMHEEEMMM