WWWWWWWMWDWWW
WMWMWWBMWBBBM
WMDMWWBWWMWWM
WDWWABBWWMWMD
WMBMDMBBWMMMW
DMBWWWMMMMMBB
MMBMWWWWWDBMW
WMWMWMDMCDWMW
WCCMCCCMWMWMM
WMDMCBBMWMWMM
WWWWCBCMWWWWW
WMWMCTPUWMWWW
WMMMWQVOAAMAA

HMEMMHEHEMMEEEEEMHEE