WWMMMMWWWWBMW
PWPWWMWWWWBWW
MWNWWWWMMMBCC
CCWMOCCMEEBBG
GCWMWDFMBWMBM
MCCCWCMMBWBBB
DCBBDCBBBWBBB
BBMMWCWWBMMWW
WMEEWCCDBMAMM
WWWWWWWWBMAMM
EEWWDMMWAMDMM
WWWWWTPUAMMMM
WWWWWQVOMWWWW

EHMHMEHEHMEHEMMMHHEE