WWWWWWWWPAMWW
MMDWWWDWMAWWM
AWWABBBBBBMBM
ACCACCBBWANWA
ACAAWWWWMACCA
CCAMMMMMWACMM
OAAWAWWWWACWW
WAHFAACCCACMD
DMHWAWWWWPPWW
WWHMMWDWWWMNN
MPWWWWMMNWDWW
WNMWWTPUDWWWW
WWWMWQVOAAAQW

EMHEMHHHEMEMEHMEMMHE