WAAAAAWAAAAAW
AAWMMMWMMMWAA
AAWMWMWMWMWAA
AAWMMMWMWMWAA
AAWWWMWMWMWAA
AAWMMMWMMMWAA
AAAAAAAAAAAAA
DWWWWPDPWWWWD
BPWPWMMMWPWPB
BMDMDMMMDMDMB
BMWMWNWNWMWMB
BMWMWTPUWMWMB
BBBWWQVOWWBBW

HEMHMEHHMMMMEHHHHHHH