WMMWWWWQMMAMW
WWWWWWAMMMAMM
MMBBBBAMMMAAM
MBDBBBACWMMAD
MBDCMMACNNDAA
WBBMMMACMMWDB
BBBAAWAWWDWWB
CCBAAMDAWBBBB
BBBMAMAADBBBB
WWWMMMAMBBWWM
EMMMWWAMBBWWM
WMMMWTPUBBWWM
WWWWWQVOWWWWM

HEMHMMMHEHEEEHHMEEEE