WWWWWWWWCEEEW
WWDWWWMWCWWWB
EMCWMWWMWWWBD
WWCMWWWWMWBCD
BBCDWWDDBBCDD
DMBWWBBBBDCMW
MDWBBBFWWWDWM
DWWHBWWHDWWWM
BWWDBWWDWWWMD
MWDDBWWEEDMWB
WDWWBMMCCMWWW
WEMWDTPUMWMMW
WWWWWQVOMWWMW

HMEHHMHMEHEMHMMMMMEE