WWWWWMWMWMMWW
WMMMDMWQMOQBB
BOWWQMMOMQMBB
BONNMMMMWMMBD
BMPPQOQMWMWCC
COWWQMMMMMWDM
DMMDMWWWWWDWM
DWWWWWWWMMMMM
MMMOWWMBNNNDD
NNNDMGDBBBBBB
BBBBMMWWBBBPP
BBBBWTPUGOWMW
WWOWWQVOWWWDW

HEMHMEHEHEEEEEEEEEEE