WMWWWWWMMMWMW
WMMWWWBBBWWNW
WNWQOWBCCCCCP
CCCBBBPMWWWWM
WWBBBBMBMWWQD
DMMEEMMMWMMMM
BMMMMBBBWDBGB
BBBDWMDCWCCCC
WCCCCMBBWQWWP
WWWWAMBBMWOWW
WGPMAMBGMWOWW
WNWMATPUMMWWW
WPWNWQVOWMWWW

HMEHEEHEHEMHMEHEEEEH