WMWWWWWMMMPWW
WMWWWWBWWWMWN
WWWMMMBCCCCCW
OCCMEEBBGGGCW
WDFMBWMBMMMCC
WCMMBWBBBBDCB
DCBBBWCCCWCCM
WCWWBMMWWWWME
WCCDBMAMMWWWW
WWWWBMAMMWEEW
DMMWAMDMMWWWW
WMAAATPUMWWWW
WMMMWQVOWWWWW

HEMHMEHMEHHHHHMEMEMH