WWWDWWWDWWWWW
BMWDWWWMWMWMW
BMWBBBWMWMDMW
BWWMWWPMWDWWA
BWWMWMDWWMBMD
BBWMMMWWDMBWW
MMMMMBBDMMBMW
WWWDBMWMWMWMW
DMCDWMWMWCCMC
CMWMWMMMWMDMC
BMWMWMMMWWWWC
CMWWWTPUWMWMC
CMWMWQVOWMMMW

HMEHEMEMHMEHEMEEMEEH