WAAAMAWAMAAAW
ABBBMWWWWWGGG
DBBBAAAAAAAAA
CBBBWWWMWMMMM
CBBBMMMNWMWQW
CBBBWWMWWWWQW
CBAAAADDDAABA
CPWPWWWWWBBBB
DMMMOQNNNBBBB
MWWWWMWPPBBBB
MWWFWWWNNCBBC
MMWFWTPUWBBBC
DMMMWQVOWMMWW

HMEMMHEHHHMEEEHMEEEE