WGBWWWWMWWWWW
BDFMMBBCBGBHD
BEBCMMPCHDFBE
WWWCBBMCBEBWW
WWWCMMMCWBGBW
GBWCMBDMWHDFW
DFWMMMMCWBEBW
EBWCBBMCWBGBW
GBWCMMMCWHDFW
DFWCMBBCWBEBW
EBWCMMMMMPWWW
WWPMMTPUMMWWD
WMMMWQVOWWWWW

HMEHEEEEMHHEEEEEEEEE