WAAAAQWOBBAAW
AOHWOWWWQBOQB
AOHWOWWWQBOQB
AMWWMMDMMBWMB
AWWQENMONFWBB
MMOWWBMBWWQMM
CAAAQBBBOAAAC
DMMWNBBBNQMMD
EEEWPWBWPWEEE
AMAAMWWWDAAAA
BMOWWNWNWWQMB
WWNWWTPUWWBBB
WWDWWQVOWWPBB

HHHMEHHHMEHHHMEHHHME