WMWWMMWWWWWWW
WWPAMWWWMMDWW
DWMAWWMWAWWAB
BBBBMBMMACCAC
BBWANWAAACAAW
WWMACCACCCAMM
MMWACMMMOAAWA
WWWACWWWWAHFA
CCCACMDMDMHWA
WWWPPWWWWWHMM
DWWWMNNNMPWWW
MMNWDTPUWNMWW
NWDWWQVOWWWMW

MMMMMMMMMMMMMMMMMMMM