WWMWWMWPWMWWW
BMMMWMWGWMMWW
BBBWWNWMWNWQO
BCCCCCMCCCCBB
MMWWWWMPWWBBB
MBMWWQDMDMMEE
MMWMMMMMBMMMM
BBWDBGBBBBBDW
DCWCCCCCWCCCC
BBWQWWPPWWWWA
BBMWOWWQWGPMA
BGMWOTPUWNWMA
AAMMWQVOWPWNA

HHMEHHMMHEMMHEEHHMHH