WWWMWWWWBGBWW
MMWWWBGBBDFMM
BCBGBHDFBEBCM
MCHDFBEBWWWCB
MCBEBWWWWWWCM
MCWBGBWBGBWCM
DMWHDFWHDFWMM
MCWBEBWBEBWCB
MCWBGBWBGBWCM
MCWHDFWHDFWCM
BCWBEBWBEBWCM
MMPWWTPUWWPMM
MMMMWQVOWMMMM

HHHMHEMHHMEHMMHEMMHH