WWWWWWWEEWWWW
WWCEEEWWWWDWW
MWCWWWBWEMCWM
WMWWWBDWWWCMW
WWMWBCDBBBCDW
DDBBCDDWDMBWW
BBBDCMWWMDWBB
FWWWDWMDDWWHB
WHDWWWMMBWWDB
WDWWWMWBMWDDB
WEEDMWBWWDWWB
MCCMWTPUWEMWD
MMMWWQVOWWWWW

HMEHMEHMEHMEHMEHMEHM