WABWWWWWWWWBW
BAWWPMMBBBBWB
BAWQMBBAMMPWE
EWAMMAAWWBBOW
WWQNWWWNMMWOW
CWQWFWFWMOWWW
WWMWPPWWMOWCC
DWMMBBAMMMWBM
DQMMBMMMMMOBM
ANNMBMMMMNNBM
AMMPNMMNPMMAB
BWNNWTPUNNWBB
DBWWWQVOWWBBW

EEEEEEMMMMMMMMMMHHHH